OOOOOOOOOO
OOOOOOOOOO
OO.OO OOOO
OOOOOOOO .
OOOOOOOOOO
OOOOOOOOOU